F 0,100,0
NO ./textures/wall.xpm
C 150,150,255
SO ./textures/bricks.xpm
WE ./textures/wood.xpm
EA ./textures/grass.xpm


11111111111111111111111111111111111111111111111111111111111111111111111111111111111111
10000000000000000000000000000000000000000000000000000000000000000000000000000000000001
10000000000000000000000000000000000011111111111111111111111000000000000000000000000001
1000000000000000000000000000000000001                     1000000000000000000000000001
1000000000000000000000000000000000001                     1000000000000000000000000001
1000000000000000000000000000000000001                     1000000000000000000000000001
1000000000000000000000000000000000001                     1000000000000000000000000001
1000000000000000000000000000000000001                     1000000000000000000000000001
1000000000000000000000000000000000001                     1000000000000000000000000001
1000000000000000000000000000000000001                     1000000000000000000000000001
1000000000000000000000000000000000001                     1000000000000000000000000001
1000000000000000000000000000000000001                     1000000000000000000000000001
1000000000000000000000000000000000001                     1000000000000000000000000001
10000000000000000000000000000000000011111111111111111111111000000000000000000000000001
10000000000000000000000000000000000000000000000000000000000000000000000000000000000001
10000000000000000000000000000000000000000000000000000000000000000000000000000000000001
10000000000000000000000000000000000000000000000000000000000000000000000000000000000001
10000000000000000000000000000000000000000000000000000000000000000000000000000000000001
10000000000000000000000000000000000000000000000000000000000000000000000000000000000001
100000000000000000000N0000000000000000000000000000000000000000000000000000000000000001
10000000000000000000000000000000000000000000000000000000000000000000000000000000000001
10000000000000000000000000000000000011111111111111111111111000000000000000000000000001
1000000000000000000000000000000000001                     1000000000000000000000000001
1000000000000000000000000000000000001                     1000000000000000000000000001
1000000000000000000000000000000000001                     1000000000000000000000000001
1000000000000000000000000000000000001                     1000000000000000000000000001
1000000000000000000000000000000000001                     1000000000000000000000000001
1000000000000000000000000000000000001                     1000000000000000000000000001
1000000000000000000000000000000000001                     1000000000000000000000000001
1000000000000000000000000000000000001                     1000000000000000000000000001
1000000000000000000000000000000000001                     1000000000000000000000000001
1000000000000000000000000000000000001                     1000000000000000000000000001
10000000000000000000000000000000000011111111111111111111111000000000000000000000000001
10000000000000000000000000000000000000000000000000000000000000000000000000000000000001
10000000000000000000000000000000000000000000000000000000000000000000000000000000000001
10000000000000000000000000000000000000000000000000000000000000000000000000000000000001
10000000000000000000000000000000000000000000000000000000000000000000000000000000000001
11111111111111111111111111111111111111111111111111111111111111111111111111111111111111
