NO ./textures/north.xpm
SO ./textures/south.xpm
WE ./textures/west.xpm
EA ./textures/east.xpm

F 220,100,0
C 225,30,0


     1111111111111111111111111111
    10000000000000110000000000001
     1111011000001110000100100001
        1001000000000000001000001
111111111011000001110000000000001
100000000011000000010111111111111
11110111111111010000000010001
11110111111111011101010010001
11000000110101011100000010001
10000000000000001100000000001
10000000000000001101010010001
11000001110101011111011110N0111
11110111 1110101 101111011111
11111111 1111111 111111111111