NO ./textures/north.xpm
SO ./textures/south.xpm
WE ./textures/west.xpm
EA ./textures/east.xpm

F 220,100,0
C 225,30,0

 1
 1111111111111111111111111111111111
 1111111111111111111111111111111111
 1111111111111111111111111111111111
 1111111111111111111111111111111111
 1111000000000000000000000000001111
 1111000000000000000000000000001111
 1111000000000000000000000000001111
 1111000000000000000000000000001111
 1111000000000000000000000000001111
 1111000000000000000000000000001111
 11110000000000000000W0000000001111
 1111000000000000000000000000001111
 1111000000000000000000000000001111
 1111000000000000000000000000001111
 1111000000000000000000000000001111
 1111000000000000000000000000001111
 1111000000000000000000000000001111
 1111111111111111111111111111111111
 1111111111111111111111111111111111
 1111111111111111111111111111111111
