NO ./textures/north.xpm
SO ./textures/yellow.xpm
WE ./textures/blue.xpm
EA ./textures/pink.xpm

F 30,150,30

C 150,150,0
 1111111111111111111111111111111111
 1111111111111111111111111111111111
 1111111111111111111111111111111111
 1111111111111111111111111111111111
 1111000000000000000000000000001111
 1111000000000000000000000000001111
 1111000000000000000000000000001111
 1111000000000000000000000000001111
 1111000000000000000000000000001111
 1111000000000001110000000000001111
 1111000000000001 100W0000000001111
 1111000000000001110000000000001111
 1111000000000000000000000000001111
 1111000000000000000000000000001111
 1111000000000000000000000000001111
 1111000000000000000000000000001111
 1111000000000000000000000000001111
 1111111111111111111111111111111111
 1111111111111111111111111111111111
 1111111111111111111111111111111111
